1111111111
10P1C01E11
1011101001
1001101101
1100000001
1111111111