111111111111111
1P00011111C1111
1111010111001C1
110000001110101
100011100000001
1E1000001111111
111111111111111