111111
1P1101
111111
1C1E11
111111