1111111111
10001101E1
1010000101
1011101101
1P1C000001
1111111111